%%%%%%%%%%%%%%%%
%31            %
%%%%%%%%%%%%%% %
%..    %.%     %
%%%%%%     %%%%%
%.      %% %.%.%
%% %%o%%%      %
%  .%  %..%%% %%
% %.%% %%.%   .%
% %%%. %%%%.% %%
% %.%% .%.%.% .%
%    % %% %%% %%
%% % %         %
%  %     %%% % %
% %%% %  .%  % %
%  %  %  %%    %
%    %%  %  %  %
% %  %.  % %%% %
% % %%%     %  %
%         % % %%
%% %%% %% %    %
%. %.%.%. %%.% %
%% %.%%%% .%%% %
%.   %.%% %%.% %
%% %%%..%  %.  %
%      %%%o%% %%
%.%.% %%      .%
%%%%%     %%%%%%
%     %.%    ..%
% %%%%%%%%%%%%%%
%            24%
%%%%%%%%%%%%%%%%