%%%%%%%%%%%%%%%%%%%
%1%              4%
% % %%%%%%%%%%%%% %
% % %           % %
% % % %%%%%%%%% % %
% % % %       % % %
% % % % %%%%% % % %
% % % %.   .% % % %
% % %.% %%% %.% % %
%.% % %o%.. % %.% %
% %.% % %%% % %.% %
% %.% % ..%o% % %.%
% % %.% %%% %.% % %
% % % %.   .% % % %
% % % %%%%% % % % %
% % %       % % % %
% % %%%%%%%%% % % %
% %           % % %
% %%%%%%%%%%%%% % %
%3              %2%
%%%%%%%%%%%%%%%%%%%